####################
#iiii#iiiiiiii#iiii#
#i##i#i######i#i##i#
#i#iiiiiiiiiiiiii#i#
#i#i##i##ii##i##i#i#
#iiiiii#GGGG#iiiiii#
#i#i##i######i##i#i#
#i#iiiiiiPi000000#i#
#i##i#i######i#i##i#
#iiii#iiiiiiii#iiif#
####################
