####################
#f000#00000000#0000#
#0##0#0######0#0##0#
#0#00000000000000#0#
#0#0##0##00##0##0#0#
#000000#0000#000000#
#0#0##0##00##0##0#0#
#0#00000000000000#0#
#0##0#0######0#0##0#
#0000#00000000#000f#
####################
