####################
#f000#00000000#0000#
#0##0#0######0#0##0#
#0#00000000000000#0#
#0#0##0###0##0##0#0#
#000000#GGGG#000000#
#0#0##0###0##0##0#0#
#0#000000P0000000#0#
#0##0#0######0#0##0#
#0000#00000000#000f#
####################









